Deutsch=English
abwischen=to erase
an der Ecke=on the corner
das Angebot, -e=offer, special
anrufen (sep)=to call
auch=also, too, as well
auf=on (+ dat)
ausgehen (sep)=to go out
das Bein, -e=leg
bekommen=to receive
billig=cheap
damals=then, at that time
dein=your [informal]
denken=to think
deshalb=because of that, since, therefore
einkaufen=to go shopping
erlauben=to allow
erz&auml;hlen=to tell
fertig=ready, finished
dazu=to this (contraction)
die Forelle, -n=trout
fragen=to ask
Freut mich!=Pleased to meet you!
die Gabel=fork
gegen&uuml;ber=opposite (+ dat)
geradeaus=straight ahead
gern=like, enjoy (adv, comes after inf. of verb)
gie&szlig;en=to pour
glatt=straight (of hair)
glauben=to think, believe
gleich=alike
der Hals, -&auml;-e=neck
hinter=behind (+ dat)
Ihr=your [formal]
die Katze, -n=cat
die Kellnerin=waitress
der Korb, -&ouml;-=basket
k&ouml;stlich=delicious
das Kraut, -&uuml;-er=herb
der Kugelschreiber, -=ball-point pen
der (die?) Kunde, -n=customer
lockig=curly
das Messer=knife
die M&ouml;hre, -n=carrot
nach=after
neben=next to (+ dat)
probieren=to try
das Rathaus=town hall
der Schalter, -=switch
der Spa&szlig;, -es, -&auml;-e=fun
die Speise, -n=dish (of food)
der Stuhl, -&uuml;-e=chair
das Tier, -e=animal
der Turm, -&uuml;-e=tower
die Unterhaltung=conversation
&uuml;ben=to practise
viele=many
vor=in front of (+ dat)
warten=to wait (+ auf + acc: to wait for)
welch(er)=which
wer?=who?
wieviel?=how many?
Wir backen einen Kuchen in der K&uuml;che.=We bake a cake in the kitchen.
wohnen=to live, dwell, inhabit
die Wolke, -n=cloud
zum Beispiel=for example
zwischen=between (+ dat)
